--www---
--w*w---
--wswwww
wwwBsB*w
w*sBPwww
wwwwBw--
---w*w--
---www--