..wwwww.
www...w.
w*PB..w.
www.B*w.
w*wwB.w.
w.w.*.ww
wB.BBB*w
w...*..w
wwwwwwww