..www...
..w*w...
..w.wwww
wwwB.B*w
w*.BPwww
wwwwBw..
...w*w..
...www..