000000000000000000
0                0
0  1             0
0                0
0                0
0                0
0                0
0                0
0                0
000000000000000000